10
10
**********
**   **g**
**5  2*  *
*8 ** **3*
**  *  4 *
*** **** *
**G  9** *
**  * **7*
*2 ** 6  *
**********
