10
10
**********
*g   **g**
**5  2*  *
*8 ** **3*
** G*  4 *
*** **** *
**G  9** *
**  * **7*
*2 ** 6  *
**********
