10
10
**********
*g   S*g**
**5  2*  *
*8 ** **3*
*  G  A4 *
***  *** *
* G  9** *
*  ** S*7*
*2 *S 6  *
**********
